  ##### 
###   # 
# @ # ##
# #  o #
#    # #
## #   #
 #A  ###
 #####  
########
########