  ##### 
###   # 
# @ # ##
# #  o #
#    # #
##@#o  #
 #A  ###
 #####  