   ###     
  ## # ####
 ##  ###  #
## @      #
#   A@ #  #
### @###  #
  #  #oo  #
 ## ##o# ##
 #      ## 
 #     ##  
 #######   