#########
#A      #
#@    @ #
#o  o   #
#       #
##   @ o#	
#########