#######
#oAX ##
#@  @ #
#   # #
#  o  #
#######