#######
#AX  ##
# @#  #
# @ o #
#o   ##
#######