######
#A   ##
# @@  #
# #o o#
#     #
#######