--####
###  #
#A o@##
#   @ #
# #o  #
#     #
#######