#####
#   #
# # ###
#Xo@  #
#  #@ #
#A   o#
#######