#########
#       #
#     @o#
# o@    #
#   A   #
#   @o  #	
#########