----####
----#  #
#####@ #
#A  # o#
#  @   #
####  o#
----####
--------