  ##### 
###   # 
# @ # ##
# #  o #
# o  # #
##@#o@ #
 #A  ###
 #####  