    #### 
 ####  # 
## @   # 
#  # #@# 
#oAo   ##
## # #  #
 #      #
 #  #####
 ####    