 ## #####
## ## o #
# ## @o #
 ## @   #
## @A ###
# @  ##  
#oo ## ##
#   # ## 
##### #  