#########
#o o    #
#o@o o  #
## ###A #
 #  @  ##
 # @@ ## 
 #  @ #  
 #  ###  
 ####    