  ###########  
 ##    #    ## 
### @ @#@ @ ###
# #@ @ # @ @# #
# @  oo#oo  @ #
#  @ooo#ooo@  #
# @ oo X oo @ #
###### A ######
# @ oo   oo @ #
#  @ooo#ooo@  #
# @  oo#oo  @ #
# #@ @ # @ @# #
### @ @#@ @ ###
 ##    #    ## 
  ###########  