-#####
##A  ##
#  #  #
# @X@ #
#  o  #
## o ##
-#####