#######
#A oo##
# #@ ##
# #   #
#  @# #
#  X  #
#######