########
##    ##
# oo   #
# # @@@#
#   #Ao#
########