-#####
##   ###
# o# @A#
#  # # #
# X  @o#
#    ###
######