######
#    ###
#   oo #
# @@@A #
#  # o #
########